1111111111111111111
1322522221222222231
1211211121211121121
1211211121211121121
1222222222222222221
1211212111112121121
1222212221222122221
1111211121211121111
1111212224222121111
1111212222222121111
1222222144412222221
1111212111112121111
1111212222222121111
1111212111112121111
1111212111112121111
1222222221222222221
1211211121211121121
1221222222222221221
1121212111112121211
1222212221222122221
1211111121211111121
1322222222222222231
1111111111111111111