11111111111111111111
13222222222522222231
12111211111211211121
12122222222222222121
12221111444411112121
12121111111111112221
12222222222222222121
12112112111211212121
13222222222222222231
11111111111111111111