1111111111
1222222241
1212122221
1212142221
1211111121
1214111121
1222222221
1212122221
1512142241
1111111111