1111111111
1223222241
1212122221
1212142221
1211111121
1212111121
1223422221
1212122221
1512142241
1111111111